############################################################
#                                                          #
#                                                          #
#                                                          #
#         *                                                #
#                                                          #
#                                                          #
#                                                          #
#                                                          #
#                                                          #
#                                                          #
#                        *                                 #
#                                                          #
#                                                          #
#                                                          #
#                                                          #
#                                                          #
#                                                          #
#                                                          #
#                                                          #
#                                                          #
#                *                                         #
#                                                          #
#                                                          #
#                                                          #
#                                                          #
#                                                          #
#                                     *                    #
#                                                          #
#                                                          #
#                                                          #
#                                                          #
############################################################