############################################################
#     #        #                                           #
#     #    *   #                                           #
#     #        #                                           #
#     ##### ####                                           #
#                                                          #
#   *                                                      #
#   ############         ############             ###      #
#                                                          #
#                            *                             #
#                            #                             #
#                            #                             #
#                            #                             #
#                           *#*                            #
#                    *###### * ######*                     #
#                           *#*                            #
#                            #                             #
#                            #                             #
#                            #                             #
###########################  *  ############################
#                                                          #
#                                                          #
#                                                          #
#                                                          #
#                                                          #
#                ############ * ############               #
#             # *           * * *            *#            #
#                ############ * ############               #
#                                                          #
#                                                          #
#                                                          #
#                                                          #
############################################################