############################################################
#     *                     ##  ##                         #
#   # ##                    #    #                  ## #   #
#   #  #                     #                      #  #   #
#  *#**#*                    #**#                  *#**#*  #
#   #  #                     #  #                   #  #   #
#   # ##                                            ## #   #
#     *                                                    #
#                                                          #
#                                                          #
#                                                          #
#                                                          #
#                                                          #
#                                                          #
#                                                          #
#                                                          #
#                                                          #
#                           * *                           *#
#*########################### ############################*#
#                             #*                           #
#                           # #                            #
#                           # #                            #
#             *                            *               #
#                           # #                            #
#                           # #                            #
#                           #                              #
############## ############## ############# ################
#*           * *            * *           * *             *#
#                                                          #
#*                                                        *#
#                                                          #
#*                                                        *#
############################################################
